3 16 17 18 15 14 14 14 14 14 14 14 14 14 14 13
3 16 17 18 19 19 19 19 19 19 19 19 19 19 19 12
3 16 17 18 27 20 20 20 20 20 20 20 20 20 20 11
3 16 17 18 21 21 21 21 21 21 21 21 21 21 21 9
4 23 17 24 21 22 21 22 21 22 21 22 21 22 21 9
3 16 17 18 22 21 22 21 22 21 22 21 22 21 22 10
4 23 17 24 21 22 21 22 21 22 21 22 21 22 21 9
3 16 17 18 22 21 22 21 22 21 22 21 22 21 22 10
4 23 17 24 21 22 21 22 21 22 21 22 21 22 21 9
3 16 17 18 22 21 22 21 22 21 22 21 22 21 22 10
4 25 26 25 21 22 21 22 21 22 21 22 21 22 21 9
5 6 7 6 7 6 7 6 7 6 7 6 7 6 7 8